1 11 18 0 17 0 2
2 2 2 2 2 2 2 0 0 0 0 0 0 0 0 0 4 0 0 4
2 2 2 2 2 2 0 0 0 0 0 0 0 0 0 0 4 0 0 4
2 2 2 2 2 0 0 0 0 0 0 0 0 0 0 0 0 0 0 0
2 2 2 2 0 0 0 0 0 0 0 0 0 0 0 0 0 2 2 2
2 2 2 0 0 0 0 0 0 0 0 0 0 0 0 2 2 2 0 0
2 2 0 0 0 0 0 0 0 0 0 0 0 0 2 2 0 0 0 0
2 2 2 2 2 2 2 0 0 0 11 0 0 0 0 0 0 0 0 0
2 0 0 0 0 0 0 0 0 0 0 0 0 0 0 0 0 0 0 0
0 0 0 0 0 0 0 0 0 0 0 0 0 0 0 0 0 0 8 6
0 0 0 0 0 0 0 0 0 0 0 0 0 0 0 0 0 0 8 6
0 0 0 0 0 0 0 0 0 0 0 2 2 2 0 0 0 0 8 6
0 0 0 0 2 2 0 0 0 0 0 2 2 2 0 0 0 0 8 6
2 2 2 2 2 2 0 0 0 0 0 2 2 2 0 0 0 0 8 6
2 2 2 2 2 2 0 0 0 0 0 2 2 2 7 7 7 7 8 6
2 2 2 2 2 2 7 7 7 7 7 2 2 2 6 6 6 6 6 6