0 12 0 0 0 0 3
13 0 0 0 0 0 0 0 0 0 0 0 0 0 0 0 0 0 0 0
12 12 12 12 12 12 12 12 12 12 12 0 0 0 0 0 0 0 0 0
0 0 0 0 0 0 0 0 0 0 0 0 0 0 0 0 0 0 0 0
0 0 0 0 0 0 0 0 0 0 0 0 0 0 0 2 0 0 8 2
0 0 0 0 0 0 0 11 0 0 0 0 0 0 0 0 0 0 8 2
0 0 0 0 0 0 0 0 0 0 0 0 0 2 0 0 0 0 8 2
0 0 2 2 0 0 0 7 0 0 0 0 2 3 2 0 0 0 8 2
0 0 2 2 0 0 0 6 0 0 0 0 4 0 4 0 0 0 8 2
0 0 0 0 0 0 2 4 0 0 0 0 4 0 4 0 0 0 8 2
0 0 0 0 0 0 0 4 0 0 0 0 4 0 4 0 0 0 8 2
0 2 2 0 0 0 0 4 0 0 0 0 4 0 4 0 0 0 8 2
0 2 2 0 0 0 0 4 0 0 0 0 4 0 4 0 0 0 8 2
0 0 0 0 0 0 2 4 0 0 0 0 4 0 4 0 0 0 0 0
0 0 0 0 0 0 0 4 0 0 0 0 4 0 4 0 0 0 0 0
5 5 5 5 5 5 5 4 7 7 7 7 4 7 4 7 7 7 7 7