1 11 18 0 17 0 4
2 2 2 2 2 2 2 2 2 2 2 3 0 0 0 0 4 13 13 4
0 0 2 2 2 2 2 2 2 2 2 3 0 0 0 0 4 0 0 4
0 0 0 0 0 0 0 0 0 0 0 3 0 0 0 0 0 0 0 0
3 0 0 0 0 0 0 0 0 0 0 4 0 0 0 0 0 0 0 0
3 3 0 0 0 0 0 0 0 0 0 6 0 0 0 0 0 0 0 0
3 3 0 0 0 0 0 0 0 0 0 0 0 0 0 0 0 0 0 0
3 3 3 0 0 0 0 0 0 0 0 0 0 0 0 0 0 0 0 2
2 2 2 2 2 2 0 0 0 0 0 6 0 0 0 0 0 0 2 2
0 0 0 0 0 0 0 0 0 0 8 4 0 6 0 0 0 0 0 4
0 0 0 0 0 0 0 0 0 0 0 4 0 4 0 0 0 6 0 4
0 0 0 3 5 5 5 3 0 0 0 4 0 4 0 6 0 4 0 4
0 0 0 0 0 0 0 0 0 0 8 4 0 4 0 4 0 4 0 4
0 0 0 0 0 0 0 0 0 0 0 4 0 4 0 4 0 4 0 4
3 5 5 5 5 5 5 5 3 0 0 4 0 4 0 4 0 4 0 4
7 7 7 7 7 7 7 7 7 7 7 4 7 4 7 4 7 4 7 4