1 4 18 0 17 0 5
2 2 2 2 2 2 2 3 3 3 3 3 3 3 3 3 4 13 13 4
0 0 0 0 3 3 3 3 3 3 0 3 3 3 2 3 4 0 0 4
0 0 0 0 3 4 3 3 3 0 0 0 3 2 2 3 4 0 0 0
0 0 0 0 0 4 3 3 0 0 0 0 3 3 0 3 4 0 0 0
0 0 0 0 0 4 3 0 0 0 0 0 0 0 0 0 4 0 0 0
2 2 0 0 0 0 4 0 0 0 0 0 0 0 0 0 2 2 0 0
4 4 7 0 0 0 3 0 0 0 0 0 0 0 0 0 0 0 11 0
4 4 6 7 0 0 4 0 0 0 8 5 5 5 5 0 0 0 0 0
4 4 6 6 0 0 4 0 0 0 0 0 0 9 5 3 0 0 0 0
4 4 6 0 0 7 4 0 0 0 0 0 0 0 9 3 0 0 0 0
4 4 0 0 8 6 4 0 0 0 0 0 0 0 0 3 0 0 0 0
2 2 0 0 5 5 5 5 5 5 5 5 5 0 0 3 10 0 0 5
0 0 0 0 0 0 0 0 0 0 0 0 0 0 0 3 10 0 0 0
0 2 2 0 0 0 0 0 0 0 0 0 0 0 8 3 7 7 7 7
7 2 2 2 2 2 2 6 7 7 7 6 2 2 2 2 2 2 2 2